╔══════╗
╔═════╗║
║╔═══╗║║
║║╔═╗║║║
║║║╚╝║║║
║║╚══╝║║
║╚════╝║
╚══════╝

A 0 0 1

I 0 0

D 2 3 1
D 3 6 2
D 4 7 3

0