╬╬╬╬╬╬╬╬
╬╬╬╬╬╬╬╬
╬╬╬╥╬╬╬╬
╬╬╬╨╬╬╬╬
╬╬╬╬╡╬╬╬
╬╬╬╬╬╨╬╬
╬╬╬╬╬╬╥╬
╬╬╬╬╬╬╬╬

